Test#eve#
##########...######################################################......#######################################
#......#...@........................................................................#..........................#
#......#............................................................................#..........................#
#......############....................................................##############..........................#
#...................................................................................#..........#...............#
#.......................................#####...#########............................#.........................#
#....................##...#####................................................................................#
#.............................................#..........................##...........................#........#
#.........................#...................#.....................................#......#...................#
#......................####...................########.............####.............#..........................#
...................................####........................................................................#
...############...............................................................................#.............#..#
....................................................................................#..........................#
#...................................................................................#..........................#
#...................................................................................#..........................#
#..............................................................................................................#
########################################################.........##################....#########################